01 00 00 00 00 00 00 00 00 00 00 00 00 00 00 01 
01 00 00 00 00 00 00 00 00 00 00 00 00 00 00 01 
01 00 00 00 00 00 00 00 00 00 00 00 00 00 00 01 
01 00 00 00 00 00 00 00 00 00 00 00 00 00 00 01 
01 00 00 00 00 00 00 00 00 00 00 00 00 00 00 01 
01 00 00 00 00 00 00 00 00 00 00 00 00 06 00 01 
01 00 00 00 00 00 00 00 00 00 00 00 00 06 00 01 
01 00 00 00 00 00 00 00 00 00 00 00 00 06 00 01 
01 00 00 00 00 00 00 02 00 00 00 00 00 06 00 01 
01 00 00 00 00 02 00 00 00 00 00 00 07 06 00 01 
01 00 00 00 00 00 00 00 00 00 00 00 00 04 00 01 
01 01 01 03 03 01 01 01 01 01 01 01 01 01 01 01 